aaguilar2018@lazearcharteracademy.com	Alex	Aguilar
aaguilar@lazearcharteracademy.com	Axel	Aguilar
aalvarado@lazearcharteracademy.com	Andres	Alvarado
aburgos@lazearcharteracademy.com	Alexsis	Burgos
acarmona2018@lazearcharteracademy.com	ANGEL	CARMONA
acastaneda2018@lazearcharteracademy.com	ALLEN	CASTANEDA
adeanda@lazearcharteracademy.com	Alberto	DeAnda
aegarcia@lazearcharteracademy.com	Andres	Garcia
afarias@lazearcharteracademy.com	Antonio	Farias
afernandez@lazearcharteracademy.com	Antonio	Fernandez
aflood2018@lazearcharteracademy.com	Amarie	Flood
aflood@lazearcharteracademy.com	Ariana	Flood
aflores@lazearcharteracademy.com	Alexander	Flores
afranco2018@lazearcharteracademy.com	CASANDRA	FRANCO
agabriel2016@lazearcharteracademy.com	Ariel	Gabriel
agabriel2017@lazearcharteracademy.com	Arath	Gabriel
agarcia@lazearcharteracademy.com	Alexis	Garcia
agdaniels@lazearcharteracademy.com	Angel	Garcia-Daniels
agonzalez@lazearcharteracademy.com	Abraham	Gonzalez
agreen@lazearcharteracademy.com	Alison	Green
aguerrero2018@lazearcharteracademy.com	Anthony	Guerrero
ahernandez@lazearcharteracademy.com	Andrew	Hernandez
aherrera@lazearcharteracademy.com	Alejandra	Herrera
ahuidor@lazearcharteracademy.com	Anel	Huidor
alrodriguez@lazearcharteracademy.com	Alejandra	Rodriguez
amahler@lazearcharteracademy.com	Alison	Mahler
amused2017@lazearcharteracademy.com	Asma	Mused
anaaguilar@lazearcharteracademy.com	Ana	Aguilar
anaguilar@lazearcharteracademy.com	Antonio	Aguilar
anrodriguez2018@lazearcharteracademy.com	ANTONIO	RODRIGUEZ VICTOR
antdavila@lazearcharteracademy.com	Anthony	Davila
antorres2017@lazearcharteracademy.com	Angel	Torres
aortega@lazearcharteracademy.com	Alejandra	Ortega
aperez@lazearcharteracademy.com	Abel	Tavarez Perez
arivas2018@lazearcharteracademy.com	Ashby	Rivas
arodriguez@lazearcharteracademy.com	Adrian	Rodriguez
arosales@lazearcharteracademy.com	Arleen	Rosales
arosas@lazearcharteracademy.com	Antonio	Rosas
aruiz@lazearcharteracademy.com	Alejandro	Ruiz
asaca@lazearcharteracademy.com	Angel	Saca
ascheirer@lazearcharteracademy.com	Allison	Scheirer
aso2018@lazearcharteracademy.com	Allison Kim	So
asoto@lazearcharteracademy.com	Andrew	Soto
atakamura@lazearcharteracademy.com	Andrew	Takamura
atirado2018@lazearcharteracademy.com	Ayleen Alison	Tirado
atorres2015@lazearcharteracademy.com	Azucena	Torres
avaldez@lazearcharteracademy.com	Ali	Valdez
avictor@lazearcharteracademy.com	Axel	Victor
awest@lazearcharteracademy.com	Andy	West
bchavarria@lazearcharteracademy.com	Briana	Chavarria
bfarias2018@lazearcharteracademy.com	BEATRIZ	FARIAS
bmedina@lazearcharteracademy.com	Britny	Medina
bperez@lazearcharteracademy.com	Bryana	Perez
brumualdo@lazearcharteracademy.com	Brandon	Rumualdo
bvilla2018@lazearcharteracademy.com	Bryan	Villavicencio
camador@lazearcharteracademy.com	Carlos	Amador
carcala@lazearcharteracademy.com	Clarence	Arcala
carias@lazearcharteracademy.com	Clarissa	Arias
cCarmona@lazearcharteracademy.com	Christian	Carmona
ccervantes@lazearcharteracademy.com	Cassandra	Cervantes
clcastillo2018@lazearcharteracademy.com	Claudinee	Castillo
creyes@lazearcharteracademy.com	Cristopher	Reyes
crollins@lazearcharteracademy.com	Christine	Rollins
crowe@lazearcharteracademy.com	Cameron	Rowe
cserralde@lazearcharteracademy.com	Christian	Serralde
ctruly2017@lazearcharteracademy.com	Caprice	Truly
dajimenez@lazearcharteracademy.com	David	Jimenez
dasanchez2018@lazearcharteracademy.com	Daisy	Sanchez
dayanatirado2016@lazearcharteracademy.com	dayana	Tirado
dbaltazar2016@lazearcharteracademy.com	Diego	Baltazar
dchavez@lazearcharteracademy.com	Daniel	Chavez
ddiaz@lazearcharteracademy.com	Dana	Diaz
dgomez@lazearcharteracademy.com	Darwin	Gomez
dhuerta2018@lazearcharteracademy.com	DANIEL	HUERTA
djimenez@lazearcharteracademy.com	Daniel	Jimenez
dlopez@lazearcharteracademy.com	Desiree	Lopez
dmartinez@lazearcharteracademy.com	Daniela	Martinez
dnuno@lazearcharteracademy.com	Daniel	Nuno
dperkins@lazearcharteracademy.com	dave	perkins
dsaravia@lazearcharteracademy.com	Dana	Saravia
dtirado2016@lazearcharteracademy.com	Dyana	Tirado
earreola@lazearcharteracademy.com	Eddie	Arreola
ecenteno2018@lazearcharteracademy.com	Emmanuel Carlos	Centeno
ecortez@lazearcharteracademy.com	Elizabeth	Cortez
edsanchez@lazearcharteracademy.com	Eduardo	Sanchez
efranco@lazearcharteracademy.com	Ernesto	Franco
ehuidor@lazearcharteracademy.com	Elsy	Huidor
elopez2018@lazearcharteracademy.com	ENRIQUE	LOPEZ
elopez@lazearcharteracademy.com	Emily	Lopez
emacias@lazearcharteracademy.com	Elissa	Macias
emarquez@lazearcharteracademy.com	Erandi	Marquez
enroll@lazearcharteracademy.com	enroll	admin
equintianilla2018@lazearcharteracademy.com	Emily Daniela	Quintanilla
erarreola@lazearcharteracademy.com	Erubiel	Arreola
erivas@lazearcharteracademy.com	Eva	Rivas
erodriguez@lazearcharteracademy.com	Edwin	Rodriguez
esanchez@lazearcharteracademy.com	Eileen	Sanchez
esantos@lazearcharteracademy.com	Emily	Santos
esifuentes@lazearcharteracademy.com	EDGAR	SIFUENTES
esolano2018@lazearcharteracademy.com	Elizabeth	Solano Garcia
esoto@lazearcharteracademy.com	Eric	Soto
evasquez@lazearcharteracademy.com	Evelyn	Vasquez
evera@lazearcharteracademy.com	Eric	Vera
Fabbatantuono@lazearcharteracademy.com	Francis	Abbatantuono
faulkners@lazearcharteracademy.com	Students	Faulkner
fgomez@lazearcharteracademy.com	Francisco	Gomez
frodriguez@lazearcharteracademy.com	Fatima	Rodriguez
g10@lazearcharteracademy.com	Galaxy	10
g11@lazearcharteracademy.com	Galaxy	11
g12@lazearcharteracademy.com	Galaxy	12
g1@lazearcharteracademy.com	Galaxy	1
g2@lazearcharteracademy.com	Galaxy	2
g3@lazearcharteracademy.com	Galaxy	3
g4@lazearcharteracademy.com	Galaxy	4
g5@lazearcharteracademy.com	Galaxy	5
g6@lazearcharteracademy.com	Galaxy	6
g7@lazearcharteracademy.com	Galaxy	7
g8@lazearcharteracademy.com	Galaxy	8
g9@lazearcharteracademy.com	Galaxy	9
gagonzalez@lazearcharteracademy.com	Gabriela	Gonzalez
garroyo@lazearcharteracademy.com	Giovanni	Arroyo Del Toro
gbautista2018@lazearcharteracademy.com	Gabriel Mendoza	Bautista
gcastillo2018@lazearcharteracademy.com	Giselle	Castillo
gdaisy@lazearcharteracademy.com	Gutierrez	Daisy
ggonzalez@lazearcharteracademy.com	Giselle	Gonzalez
gigonzalez2018@lazearcharteracademy.com	Gilberto	Gonzalez
gmedina@lazearcharteracademy.com	Graciela	Medina
gmonge@lazearcharteracademy.com	Gamileth	Monge
gochoa2016@lazearcharteracademy.com	Gabriela	Ochoa
gparedes@lazearcharteracademy.com	Grace	Paredes
gpreciado@lazearcharteracademy.com	George	Preciado
grosas@lazearcharteracademy.com	Guadalupe	Rosas
gvazquez@lazearcharteracademy.com	Gabriela	Vazquez
hbledsoe@lazearcharteracademy.com	Harold	Bledsoe
hcastaneda@lazearcharteracademy.com	Hugo	Castaneda-Zamora
hmora@lazearcharteracademy.com	Hector	Mora
hsteen@lazearcharteracademy.com	Halona	Steen
hvarela@lazearcharteracademy.com	Humberto	Varela
Idelatorre@lazearcharteracademy.com	Isaac	De La Torre
ielvira2018@lazearcharteracademy.com	DIEGO	ELVIRA
ihandy@lazearcharteracademy.com	Isaish	Handy
jaramirez2017@lazearcharteracademy.com	Jaime	Ramirez
jarias2018@lazearcharteracademy.com	JOSHUA	ARIAS AMADOR
jarriaga2018@lazearcharteracademy.com	Joshua Luis	Arriaga
javila@lazearcharteracademy.com	Jonathan	Avila
jbarajas@lazearcharteracademy.com	Jesus	Barajas
jbarnett@lazearcharteracademy.com	Jonathan	Barnett
jblenis@lazearcharteracademy.com	Jennifer	Blenis
jcastellanos@lazearcharteracademy.com	Jacquelyn	Castellanos
jcastro2017@lazearcharteracademy.com	Jeovany	Castro
jchavez@lazearcharteracademy.com	Julissa	Chavez
jdavila2018@lazearcharteracademy.com	Jovanny	Davila
jdominguez@lazearcharteracademy.com	Jesus	Dominguez
jelias@lazearcharteracademy.com	Johnathan	Elias Romero
jfonseca2018@lazearcharteracademy.com	Jose Manuel	Fonseca Martinez
jfranco@lazearcharteracademy.com	Jose	Franco
jgiron@lazearcharteracademy.com	Jeremy	Giron Zuniga
jgoogle@lazearcharteracademy.com	James	Google
jmarin@lazearcharteracademy.com	Jose	Marin
jmontes@lazearcharteracademy.com	Jazmin	Montes de Oca
jnavarro@lazearcharteracademy.com	Juan	Navarro
johnher@lazearcharteracademy.com	Jonathan	Hernandez
jovanher@lazearcharteracademy.com	Jovan	Hernandez
jpalacios@lazearcharteracademy.com	Jaquelin	Palacios
jperez2016@lazearcharteracademy.com	Jonathan	Perez
jquintero@lazearcharteracademy.com	Jocelyn	Quintero
jramirez2016@lazearcharteracademy.com	Julian	Ramirez
jramos@lazearcharteracademy.com	Jessica	Ramos
jsalgado@lazearcharteracademy.com	Jair	Salgado
jsalinas@lazearcharteracademy.com	Jorge	Salinas
jsaul@lazearcharteracademy.com	Jonathan	Saul
juaraica@lazearcharteracademy.com	Justin	Araica
jvillavicencio@lazearcharteracademy.com	Juan	Villavicencio
kaldickey@lazearcharteracademy.com	Kalvyn	Dickey
kbarber@lazearcharteracademy.com	Katherine	Barber
kcruz@lazearcharteracademy.com	Karen	Cruz
kdickey@lazearcharteracademy.com	Kassandra	Dickey
kgarcia@lazearcharteracademy.com	Kevin	Garcia
khernandez@lazearcharteracademy.com	Kimberly	Hernandez
kkodam@lazearcharteracademy.com	Kristy	Kodam
kmartinez@lazearcharteracademy.com	Kevin	Martinez Espinoza
kramirez@lazearcharteracademy.com	Keila	Ramirez
ksoto2018@lazearcharteracademy.com	Karola	Soto
kvilla2016@lazearcharteracademy.com	Kelvin	Villa
lalvarez@lazearcharteracademy.com	Lazaro	Alvarez
lbarajas2018@lazearcharteracademy.com	Lydia	Barajas
lbazan@lazearcharteracademy.com	Lino	Bazan
lgomez2018@lazearcharteracademy.com	LUIS	GOMEZ
lguerrero@lazearcharteracademy.com	Leslie	Guerrero
lhernandez@lazearcharteracademy.com	Leslie	Hernandez
lherrera2018@lazearcharteracademy.com	Luis Fernando	Herrera Lopez
lkirk@lazearcharteracademy.com	Louis	Kirk
lmstest@lazearcharteracademy.com	lms	test
lpeou@lazearcharteracademy.com	Laura	Peou
lsilvafernandez2016@lazearcharteracademy.com	Lidia	Silva Fernandez
lsmith@lazearcharteracademy.com	Layonnie	Smith
ltorres@lazearcharteracademy.com	Luis	Torres
lulopez2018@lazearcharteracademy.com	Luis Lopez	Picazo
lulopez@lazearcharteracademy.com	Lopez	Luis
maortega@lazearcharteracademy.com	Miguel Angel	Ortega
mayala@lazearcharteracademy.com	Martha	Ayala-Mireles
mbastida@lazearcharteracademy.com	Melany	Bastida
mchavez@lazearcharteracademy.com	Maria	Chavez
mcruz@lazearcharteracademy.com	Miriam	cruz
mdeleon2018@lazearcharteracademy.com	Melinda	De Leon
mdeleon@lazearcharteracademy.com	Melina	De Leon
mdraganic@lazearcharteracademy.com	Mira	Draganic
mfotouhi@lazearcharteracademy.com	Melissa	Fotouhi
mgomez@lazearcharteracademy.com	Michael	Gomez
mgonzalez@lazearcharteracademy.com	Miguel	Gonzalez
mhuerta@lazearcharteracademy.com	Manuel	Huerta
mleon@lazearcharteracademy.com	Mauricio	Leon
mloza2018@lazearcharteracademy.com	MICHELLE	LOZA RANGEL
mmalendez@lazearcharteracademy.com	maribel	malendez
mmartinez@lazearcharteracademy.com	Maria	Martinez
mmendoza@lazearcharteracademy.com	Marcelina	Mendoza
mmuse2018@lazearcharteracademy.com	Michael Damien	Muse Jr.
mosantos@lazearcharteracademy.com	Moses	Santos
mpadilla@lazearcharteracademy.com	Mario	Padilla
msantos@lazearcharteracademy.com	Madeline	Santos
msblenis@lazearcharteracademy.com	Ms	Blenis
mserralde2018@lazearcharteracademy.com	Melissa	Serralde
msmahler@lazearcharteracademy.com	Ms	Mahler
nbastida2017@lazearcharteracademy.com	Natalie	Bastida
nnavarro@lazearcharteracademy.com	Natalia	Navarro
nolivares@lazearcharteracademy.com	Nataly	Olivares
nreynoso@lazearcharteracademy.com	Nayeli	Reynoso
ohernandez@lazearcharteracademy.com	Olga	Hernandez
pababei@lazearcharteracademy.com	Petrut	Ababei
pestrada@lazearcharteracademy.com	Paola	Estrada
ppablo2018@lazearcharteracademy.com	Paula	Pablo Mendoza
pthao@lazearcharteracademy.com	Paul	Thao
rcabezas@lazearcharteracademy.com	MsR	Cabezas
rcampos2018@lazearcharteracademy.com	Raquel	Lopez-Campos
rchavez@lazearcharteracademy.com	Ramon	Chavez
rcohen@lazearcharteracademy.com	Rashad	Cohen
rcollignon@lazearcharteracademy.com	Robyn	Collignon
reparedes@lazearcharteracademy.com	RElena	Paredes
rfrancisco2018@lazearcharteracademy.com	Francisco Rumualdo	Leon
rgalaviz@lazearcharteracademy.com	Rosa	Galaviz
rgarcia@lazearcharteracademy.com	Ricardo	Garcia
rguard@lazearcharteracademy.com	Relina	Guard
rgutierrez@lazearcharteracademy.com	Roberto	Gutierrez
rmartinez@lazearcharteracademy.com	Ramona	Martinez
rolivares@lazearcharteracademy.com	Ruben	Olivares
romartinez@lazearcharteracademy.com	Rosa	Martinez
rortega@lazearcharteracademy.com	Ruth	Ortega
rsanchez@lazearcharteracademy.com	Rosa	Sanchez
rsantana2018@lazearcharteracademy.com	REBECCA	SANTANA
rsolis@lazearcharteracademy.com	Rocio	Solis
sbannavong@lazearcharteracademy.com	Sithy	Bannavong
sbrumfield@lazearcharteracademy.com	Spenser	Brumfield
sestrada@lazearcharteracademy.com	Stephany	Estrada
sgonzalez@lazearcharteracademy.com	Smith	Gonzalez
sgoose@lazearcharteracademy.com	Susan	Goose
sjorge@lazearcharteracademy.com	Solange	Jorge
smacray@lazearcharteracademy.com	Shelley	MaCray
smuse@lazearcharteracademy.com	Sanaa	Muse
smused@lazearcharteracademy.com	Saud	Mused
spadilla@lazearcharteracademy.com	Santiago	Padilla
spicado@lazearcharteracademy.com	Sofi	Picado
srendon2018@lazearcharteracademy.com	Samuel	Rendon
ssantos@lazearcharteracademy.com	Sergio	Santos
tgonzalez@lazearcharteracademy.com	Tomas	Gonzalez
tguard@lazearcharteracademy.com	Tamea	Guard
tlopez@lazearcharteracademy.com	Tony	Lopez
vbibiano2018@lazearcharteracademy.com	VANESSA	BIBIANO
vcarreno@lazearcharteracademy.com	Valerie	Carreno Marroquin
vhernandez@lazearcharteracademy.com	Victor	Hernandez
vortega@lazearcharteracademy.com	Vicente	Ortega
vward@lazearcharteracademy.com	Variah	Ward
xcarradine@lazearcharteracademy.com	Xavier	Carradine
xleon2018@lazearcharteracademy.com	Xiomara	De Leon
xramirez@lazearcharteracademy.com	Xzjael	Ramirez
ycater@lazearcharteracademy.com	Yolanda	Cater
ydiaz2018@lazearcharteracademy.com	Yadirah Marie	Diaz Elliott
ygonzalez@lazearcharteracademy.com	Yuletzi	Gonzalez
yhernandez@lazearcharteracademy.com	Yahaira	Hernandez
ymariscal@lazearcharteracademy.com	Yozelin	Mariscal-Palomino
ypablo2016@lazearcharteracademy.com	Yenifer	Pablo